***************
*             *
*             *
*      P      *
*             *
*             *
*      M      *
*             *
*             *
*             *
*             *
*             *
*      G      *
***************