***************
*      M      *
*        **   *
* **   P      *
*             *
*       *  *  *
*      M *    *
* M        *  *
*      *  *   *
*  *       M  *
*    ** **    *
*    *  M*    *
*    * G *    *
***************